9 23
|---------------------|
|..F|..-..............|
|..-|.................|
|.....................|
|.F....-..............|
|......@..............|
|......-........P-----|
|.....................|
|---------------------|