9 23
|---------------------|
|..F|..-..............|
|..-|.................|
|.....................|
|.F....-..............|
|......@........C.....|
|......-........P....-|
|.....................|
|---------------------|